13 0 0 13 13 13 13 13 13 13 13 13 13 13 13 4 5
13 0 0 13 13 13 13 13 13 13 13 13 13 13 13 4 5
13 0 0 13 13 13 13 13 13 13 13 13 13 13 13 4 5
13 0 0 13 13 13 13 13 13 13 13 13 13 13 13 4 5
13 0 0 0 0 0 0 0 0 0 0 0 0 13 13 4 5
13 0 0 0 0 0 0 0 0 0 0 0 0 13 13 4 5
13 0 0 0 0 0 0 0 0 0 0 0 0 13 13 4 5
13 0 0 13 13 13 13 13 13 13 13 13 31 13 13 4 5
13 0 0 0 0 0 0 0 0 0 0 0 0 13 13 4 5
13 0 0 0 0 0 0 0 0 0 0 0 0 0 15 16 5
13 0 0 0 0 0 0 0 0 0 0 0 0 0 14 16 5
12 12 12 12 12 12 12 12 12 12 12 12 12 12 12 12 12
12 12 12 12 12 12 12 12 12 12 12 12 12 12 12 12 12
Coin 192 288
Coin 240 288
Coin 288 288
Coin 336 288
Coin 384 288
Coin 432 288
Coin 480 288
Coin 528 288
Coin 144 480
Coin 192 480
Coin 240 480
Coin 288 480
Coin 336 480
Coin 384 480
Coin 432 480
Coin 480 480
Coin 528 480